#############
#           #
#    P      #
#       #####
#      #    #
#O    #     #
#            ######
#                 #
#                 #
#           X    #
# O             #
################
