#############
#    O      #
#    P      #
#       #####
#      #    #
#     #   O #
#            ######
#                 #
#     X           #
#     X          #
#O     X        #
################
