#############
#X   O     X#
#     P     #
#       #####
#      #    #
#     #   O #
#            ######
#                 #
#         O       #
#                #
#X      O      X#
################
