#############
#           #
#    P      #
#       #####
#      #    #
#     #     #
#            ######
#         X       #
#                 #
#           X    #
# O             #
################
