#############
#           #
#    P      #
#       #####
#      #    #
#     #     #
#            ######
#                 #
#                 #
#           X    #
#               #
################
