#############
#    O      #
#    P      #
#       #####
#      #    #
#     #   O #
#            ######
#                 #
#                 #
#                #
#O              #
################
