#############
#       O   #
#  P    #####
#           #
#           #
#           #
#  ##       #
#####       #
#O       XX #
#        #  #
#############
